NO ./texture/north_tex.xpm
SO ./texture/south_tex.xpm
WE ./texture/west_tex.xpm
EA ./texture/east_tex.xpm

C 92,148,252
F 200,76,12

111111111111
100000000001
100000000001
10000S000001
100000000001
100000000001
100000000001
111111111111
